# #############
#             #
##### #########
#       #     #
# #######     #
#             O
#######  ######
      #  #
      ####