# #########
#        _#
#### ####_#
#         #
# #########
#O#########
