# ###################################
#                                   #
############### ################### #
#               #                   #
# ############### ###################
#                                   O
#####################################