# ##########################
#                          #
########## # #####      #  #
#          # #######    #  #
# ########## ######## # ####
#          # ###  ##  # #  #
########## #   #  #####    #
#          #####  ##  #### #
### ##########    ##     # #
#     #           #        #
#      #########  # ########
#                          O
############################                          